R 800 600

NO ./rsrc/textures/wall256.xpm
SO ./rsrc/textures/wall256.xpm
WE ./rsrc/textures/wall256.xpm
EA ./rsrc/textures/wall256.xpm
S ./rsrc/textures/simon256.xpm
F 220,100,0
C 225,30,0

      111111111111111111111111111
      100000000000110000000000001
      121211000001110000000000001
      100100000000000000000000121
111111110011000001110000000000001
100000000011000001110111111111111
11110111111111011100000010001
01110111111111011101010000001
11000000110101011100000010001
10000000000000001100000010001
10200000000000001101010010101
11000001110101011111011110N0111
11110111 1110101 101111000001
11111111 1111111 111111111111
